11111111111111111111111111111111111111111111111111111111111111111111111111111111
1CCCCCCCCCCCCCCCCCCCCCCCCCCCCCCCCCCCCCCCCCCCCCCCCCCCCCCCE1CCCCCCCCCCCCCCCCCCCCC1
1C111111111111111111111111111111111111111111111111111111111111111111111111111111
1CCCCCCCCCCCCCCCCCCCCCCCCCCCCCCCCCCCCCCCCCCCCCCCCCCCCCCCC1CCCCCCCCCCCCCCCCCCCCC1
11111111111111111111111111111111111111111111111111111111P11111111111111111111111
11111111111111111111111111111111111111111111111111111111111111111111111111111111