1111111111111111111111111111111111111111111111
1E0000M00000000000M00000000M00M00000000M000001
100MMMMMMMMMM00MMMM00M00MMMM00MMMM00M00M00MMM1
100000M00M00000000000M00000000M00000M00M000001
1MMM00M00M00M00MMMM00MMMMMMMMMM00M00M00M00M001
100000000000M00000M00M00000M00000M00M00000M001
1MMM00MMMMMMMMMMMMMMMM00M00MMMMMMM00M00MMMMMM1
100000M00000000M00000M00M00M00M00000M00000M001
1MMM00M00MMMMMMMMMM00MMMM00M00MMMM00MMMMMMM001
100000000M00000M00000000000000000000M000000001
100M00M00MMMM00M00MMMM00MMMMMMMMMM00M00MMMMMM1
100M00M00M00000000000M00000000M00000000M000001
100M00M00M00M00MMMM00MMMM00MMMM00M00MMMMMMM001
100M00M00000M00000M00000M00000M00M000000000001
1MMMMMMMMMMMMMMMMMMMMM00MMMMMMMMMMMMMMMMMMM001
100000000000M00000M00000000000000000000M000001
100M00MMMMMMM00MMMM00MMMMMMMMMM00MMMMMMMMMM001
100M00M00000000M00000M00000M00000000M00M00M001
1MMM00MMMMMMM00M00M00MMMM00M00M00MMMM00M00MMM1
100000000M00000000M00M00M00000M00M000000000001
1MMM00M00M00MMMMMMM00M00MMMMMMM00M00M00MMMMMM1
100M00M00000M00000M00M00000000M00M00M000000001
100M00M00MMMM00MMMM00M00M00MMMM00M00M00MMMM001
100000M00000M00M00000M00M00M00M00000M00000M001
100MMMM00M00M00MMMMMMM00MMMM00M00MMMMMMM00MMM1
100000M00M00000000M00000000000M00000M00M00M001
100M00MMMM00M00M00MMMMMMM00MMMMMMM00M00M00M001
100M00M00M00M00M00000M00000M00000M00M00M00M001
1MMMMMM00MMMM00MMMM00M00MMMM00MMMM00M00M00M001
100000000000000M00000M00000000000000M000000CP1
1111111111111111111111111111111111111111111111