11111111111111111111111111111111111
10010001E00000001000000110000010001
1011100100000000110C111110101000101
100C000111111C001000000110101111101
110000110000100011110C0110100000101
11100000000000000000000000111111101
10111111111111011111111110010000101
10111111111111011111111110010000001
100100010C1001000000000111011111111
101110010000010C0000000000000000001
100C0001111101000000000110000000001
11000011000001000000C00110000111111
110000000011110001111001111001C0001
11001111001001000111100110P00111101
111110000000C000000000C010000000001
10000011111001000000C00110000111111
10111110001111000111100111111111011
1000000000000100011110011000C001011
110000000000C000000000C010000000001
1100000000000100011110011000C001011
110000000000C000000000C000000000011
11111111111111111111111111111111111