11111111111
1PCEA000001
11111111111