11111111111111111111111111111111111
1MC00000000000000000000000000000001
11111111111111111111111111111111101
11111111111111111111111111111111101
11111111111111111111111111111111101
11111111111111111111111111111111101
11111111111111111111111111111111101
11111111111111111111111111111111101
11111111111111111111111111111111101
11111111111111111111111111111111101
11111111111111111111111111111111101
11111111111111111111111111111111101
10000000000000000000000000000000001
10111111111111111111111111111111111
10000000000000000000000000000000001
11111111111111111111111111111111101
10000000000000000000000000000000001
10111111111111111111111111111111111
10000000000000000000000000000000001
111111111111111111111111111111111P1
10001000100010001000100010001000101
10M01010101010101010101010101010101
10101010101010101010101010101010101
10101010101010101010101010101010101
10101010101010101010101010101010101
10101010101010101010101010101010101
10101010101010101010101010101010101
10101010101010101010101010101010101
10101010101010101010101010101010101
1E100010001000100010001000100010001
11111111111111111111111111111111111