111111111
1M11111E1
1P00C0001
111111111